R----#----
-----#----
-----#----
-----#----
-----#----
-----#----
----------
--------#-
--------#-
--------#X