R-----#-------
------#---#---
---#--#---#---
---#------#--X
---#--#---#---
------#-------
--------------
