R-----#--X
------#---
---#--#---
---#------
---#--#---
------#---
----------
----------
----------
----------